@@@@@@@@@@@@@@@@@@@@@@@@@@@@@@@@@@@@@@@@@@@@@@@@@@@@@@@@@@@@@@@@@@@@@@@@@@@@@@@@
@...@.......@.....@.......@...................@.......@.............@.........@.
@@@.@.@@@@@.@.@.@@@.@@@@@.@.@.@@@@@@@@@@@@@@@.@.@@@.@.@@@@@.@@@@@@@.@.@.@@@@@.@.
@.@...@...@.@.@.........@...@.@.......@.....@.@...@.@.....@.@.......@.@.@...@...
@.@@@@@.@.@.@@@@@@@@@@@@@@@@@.@.@@@@@.@@@.@.@.@@@@@.@@@@@.@.@.@@@@@.@.@.@.@.@@@.
@.......@.@...@...@.....@.....@.@...@...@.@.@.......@.@...@.@...@...@.@...@.@...
@.@@@.@@@.@@@.@.@.@.@@@.@.@@@@@.@@@.@@@.@.@@@@@@@@@@@.@.@@@@@.@.@@@.@.@@@@@.@@@@
@...@.@.....@...@...@.@.@.......@...@...@.............@.....@.@...@.@.@...@.....
@@@.@.@@@@@@@@@@@@@@@.@.@@@@@@@.@.@.@.@@@@@.@@@.@@@@@@@@@@@.@.@@@.@@@.@@@.@@@@@.
@...@.................@...@...@...@.@.....@...@...........@.@...@...@.......@.@.
@.@@@@@@@@@.@@@@@@@@@.@@@.@.@.@@@@@.@@@@@.@@@.@@@@@@@.@.@@@.@.@@@@@.@@@@@@@.@.@.
@.....@...@...@...@...@.@...@.@...@.....@.@...@...@...@.@...@.@...@.......@...@.
@@@@@.@.@.@@@.@@@.@.@@@.@@@@@.@.@@@@@@@.@.@.@@@@@.@.@@@@@.@@@@@.@.@@@@@.@.@.@@@.
@.@.....@...@.@...@...@...@...@.......@.@.@.@...@.@.......@.....@.@...@.@...@...
@.@.@@@@@@@@@.@.@@@@@.@.@.@.@@@.@@@.@@@.@.@.@.@.@.@@@@@@@@@.@@@@@.@.@.@@@@@@@.@.
@.@...@.......@...@.....@.@.@.@...@...@.@.@...@...@...........@.@.@.@...@.....@.
@.@@@.@.@@@@@@@@@.@.@@@@@@@.@.@@@.@@@.@.@.@@@@@@@.@@@.@@@@@@@.@.@.@.@@@.@.@@@@@.
@...@.@.........@.....@.....@...@...@...@...@...@...@...@.....@.@.@.@...@...@.@.
@.@@@.@@@@@@@@@.@@@@@@@.@@@@@@@.@@@.@@@@@@@.@.@.@@@.@@@@@.@@@@@.@.@.@.@@@.@.@.@.
@.....@.......@.......@.....@...@...@.......@.@.....@.....@.....@...@...@.@.@...
@.@@@@@@@@@.@.@@@@@@@.@@@@@.@.@@@.@@@.@@@@@@@.@@@@@@@.@@@@@@@.@@@@@@@@@.@.@.@.@@
@.@...@...@.@.....@.......@.@.....@.@.....@.....@.....@.....@.....@.....@.@.@.@.
@.@.@.@.@.@@@@@@@.@.@@@@@@@.@.@@@@@.@@@@@.@@@@@.@.@@@@@.@.@.@@@.@.@.@@@@@@@.@.@.
@.@.@...@.......@.@.....@...@.....@.....@.....@...@...@.@.@.....@.@.@.......@...
@.@.@@@@@@@@@@@.@.@@@@@.@.@@@@@@@.@@@.@@@@@.@.@@@@@@@.@.@.@@@@@@@@@.@.@@@@@@@@@.
@...@.........@.@.....@.@.......@.....@...@.@.......@...@.........@...@.......@.
@@@@@.@@@.@@@.@.@@@.@@@.@@@@@@@.@@@@@@@.@.@.@@@@@@@.@@@.@@@@@@@@@.@@@@@.@.@@@@@.
@...@.@.@.@...@...@.@.....@...@.......@.@.@...@...@...@.@...@.@.......@.@.....@.
@.@.@.@.@.@.@@@@@.@.@.@@@.@.@@@@@@@@@.@.@.@@@.@.@@@@@.@.@.@.@.@.@@@@@@@.@@@@@.@.
@.@.....@.@.@...@.@.@.@.@.@.@.........@.@.@.@...@...@.@...@.@.@.@.......@...@...
@.@@@@@@@.@.@.@.@.@.@.@.@.@.@.@@@@@@@@@.@.@.@@@.@.@.@.@@@@@.@.@.@.@@@@@@@@@.@@@@
@.....@...@.@.@.@...@.@...@.@.@...@.....@.@.....@.@.@.@.......@.@...@...........
@@@@@.@.@@@@@.@.@@@.@.@@@.@.@.@.@.@.@@@@@.@@@@@.@.@.@.@.@@@@@@@.@@@.@@@@@.@@@@@.
@.....@.@.....@.....@...@...@...@...@...@.@...@.@.@.@.@...@.......@.....@.....@.
@@@@@@@.@.@@@@@@@@@@@@@.@@@.@@@@@@@@@.@.@.@.@.@@@.@.@.@@@@@.@@@@@@@@@@@.@.@@@.@.
@.....@.@.@...@.......@...@.....@.....@.@.@.@.....@.@.....@.........@...@...@.@.
@.@@@.@.@.@@@.@.@@@@@.@@@.@@@@@@@.@@@@@.@.@.@@@@@@@.@@@@@.@.@@@@@.@@@.@@@@@@@.@.
@...@...@...@.......@...@.@.....@.@.....@.@.@.....@.@...@.@.@...@...@.....@...@.
@.@.@@@@@@@.@@@@@@@@@.@.@.@.@@@.@.@.@@@@@.@.@.@.@@@.@.@.@.@.@@@.@@@.@@@@@.@.@@@.
@.@...................@.@.....@...@.........@.@.......@...@.......@.........@...