@@@@@@@@@@@@@@@@@@@@@@@@@@@@@@@@@@@@@@@@@@@@@@@@@@@@@@@@@@@@@@@@@@@@@@@@@@@@@@@@@@@@@@@@@@@@@@@@@@@@@@@@@@@@@@@@@@@@@@@@@@@@@@@@@@@@@@@@@@@@
@@@@@@..@@@@@@@@@@@@@@@@@@@@@@@@@@@.@@@@@@@@@@@@@@@@@@@@@.@@@.@@@@@.@@@@@.@@@@.@.@@@@@@.@@=@@@.@@@@@@@@@@@@@@@@.@@@@@@.@@@@@@@@@@=@@@@@@@@@@
@@=.=..=......=............=.=...........=.........==..=.=...=............=........=.......=.......=..=...=....=.........................=@@
@@=.@@@@......@@...=....@@....@@=@..................==@@.=..@@................=...@@...==.....=.......@@@@@@=.@..=......@=........=.......@@
@@..=...=...=.=...=....=........=.......................==..=...==...............=....=...........................=......=.=..............@@
@@..@@....@@@@........@@===.@.........@@@@....@.=..@@@....@@......=.==..........@@@@..................@@@@=...@@@.@@..@@....@@@@@@........@@
@....=...=..=............=......=.........==................=...=.....=..=.....==....................=.=.=.........==..=..................@@
@@@@....@@..=.=....=@@.@...........=.@....=......=......@@..=....=@@..=..=...=...........=@@.........@@..=....@@@@=.@@......=.@.=.......=.@@
@@......=.........==.....=..=.=...............==...........=........=...............=.=..............=..=......................=......=...@@
@@.......=@@.=@@........@.............=..=.@.....=.@......=.....@@.=.....=.=............@......@.@....@@....@@@@@@..........=....=@=..@@=.@@
@@..........=.=......=......=...........=.......=.............=.=.....................=...=....=.......==..........................=......@@
@@..@.......@@..@@@@..@.=@@@..@@....@@....@.@......@.@@@....@@....@@@....=.....=...=.......=.=.=..@@....=...=..@.=..@@@@.@......@=.=....@@@@
@@...................==...............=.......=...=...=.......................=.................=..=..........=.....==.=.................=@@
@@@@...=.=....@@=....=..=.==......@@.==.@@@@@.........====....@@..@@@@..=@=@@@@@......@=........@@..........=....@....@@@.@@.=......==..=.@@
@@.................................=..=...===......=............=....=........=..........==.......=........................=.=...==...=...@@
@@.@@...=@@@......=.@@.....=@@@@@@=...@@.=@@@@@@........@.....@@@@@@...@@...==@.@@...@@@@@..@@..@.@@....@@..@@@@.......=@@......=.........@@
@@....=...=.=..........=...........=......==....=.=...=.........=........=...=......==...=................=.........=.........=...=......=@@
@@......@@@@@@...=@@..@@=.......@@......=.......@@@@..@@@@..@@.@@@.@.....=@@.=....@@...=..@...........@@..@.........@@==...==.............@@
@@..==.................=.==....=.......=...==...............==.=.......=..................=..=......=...=................=..=.............@@
@@....@@....@@......@@.@@@@...@@..............@@............@...@..........@@..=@@...=..@@.@..@@.@@.@@@@@@=.@@........@....=......@@......@@
@@==........=.........=..............................=.......==...=............=...===..............=.....=........=........=.....=.......@@
@@......@@@@..@@..=..=.@.................=....@@@.....@...@==.....@@.=..=.=...@@...........=....=...@@@@..@@.............=.........=......@@
@@.=..=.....=...............=.....................................=......=........=...........=.....=........=.=.........=......=......=.=@@
@@.....=...=....@@.@@@..=.......=.....@@@..=..........=..@@@@@...@.=@@.@..==@@@@@@@@..=...@..@..@@@.....@@@@@@.......=.=.=......@@@@......@@
@@=.........=...=..=......................=....=..........=.=....==................=.............=......=...=...................=.....=...@@
@@..==@@@=.....=....@...@@@.@........@...=.==.....=.....=..==.@.@.@..=..@@....@@@.........@....@....=.@......................=...........=@@
@@.......=...............=.....=.............=...........=.....=............................=...............=..............=...=..........@@
@....=.=..........@@@@@@@@.......=@@......=...........=...=.........@@......@@@@@@.......=...@.....=..........@@@@..........=.....=.......@@
@@...........=.....=.====..................=.................................=....=....=.......=.............=..........=..=..............@@
@@........=..=.@@....==.=...=.@@..@.@.@@..==..@=@@..........@@@@..@@..@@.....=@@..@@..@.@@@...........=....@@@@@.....=....=.==............@@
@@=......=.....=..................=.......=........=....=.................=.=.................=...==..........=...........................@@
@...@@@@........=...................@@......@@@@......@@....@@...@....=...@@..=.....@@..@@..........=.=........=@@@@..=...=.............=.@@
@@........==......=........=.....==.............=...=.=......=.......=.................=............=..=......===.=.......................@@
@@@@..@@.@@@....@@@@....@.@@=.@@@@....@@.=@@@@=..=@@@@......=..@=......=....@@.=......@..=@@@@............==@@.........=..=...........@...@@
@@.....................=.......=......=..............==.............=..=...=..=........==............=................=..=..=.......=...=.@@
@@=.@@..@@..@.=.............@@..@@@@=.@@@@.=..@@=@@@..@............===...=.=.@...=@@.....@....=........=..=@...=..@@@@@@..@@....@..=@@....@@
@@.=.................=...........==..................=.......=.=..............=...................=....=.......==...................=.....@@
@@....@@......@@..@@....@@@..=@@......=..=@=.@..@@..@@@@@...............@@.@...=@@@.@....=@@@@......@@..=...@@@@@=......@@....@@..@@=.....@@
@@...................=.......................=...........=...=..=....==.......=......=...=..................=.............=...............@@
@@@@@@@@@@@@@@@@@@@@@@@@@@@@@@@@@@@@@@@@@@@@@@@@@@@@@@@@@@@@@@@@@@@@@@@@@@@@@@@@@@@@@@@@@@@@@@@@@@@@@@@@@@@@@@@@@@@@@@@@@@@@@@@@@@@@@@@@@@@@