############################################################
#..........#..........#....................#...............#
#.##########.##########.##########.##########.############.#
#.#........#.#........#..........#.#........#............#.#
#.#.########.#.########.##########.#.########.##########.#.#
#.#.#......#.#........#.#........#.#.#......#.#........#.#.#
#.#.#.######.########.#.#.######.#.#.#.######.#.######.#.#.#
#.#.#.#....#..........#.#.#....#.#.#.#.#....#.#.#....#.#.#.#
#.#.#.#.##.############.#.#.##.#.#.#.#.#.##.#.#.#.##.#.#.#.#
#.#.#.#..#..............#.#..#.#.#.#.#.#..#.#.#.#..#.#.#.#.#
#.#.#.####.##############.####.#.#.#.#.####.#.#.####.#.#.#.#
#.#.#..........................#.#.#.#......#.#......#.#.#.#
#.#.############################.#.#.########.########.#.#.#
#.#..............................#.#...................#.#.#
#.################################.#####################.#.#
#.................................*......................#.#
########################################################..*#
############################################################